***************
***########****
***#***********
***#******#****
**********#****
***#******#****
***#******#****
***########****
***************
