**********
**######**
**#****#**
**#*******
*******#**
**#****#**
**#****#**
**#****#**
**######**
**********
