##############################################
               #     #        #  #        #  #
#  ##########  ####  #  ####  #  #  #  #  #  #
#     #     #           #     #     #  #     #
####  #  #  #######  ####  ################  #
#  #     #     #        #        #     #     #
#  ##########  ################  #  #  #  ####
#           #  #     #        #  #  #     #  #
#  #######  #  #  #  #  ####  #  #  #######  #
#  #     #     #  #  #  #     #     #     #  #
#  #  #  #######  #  #  #  ##########  ####  #
#     #     #     #     #  #     #     #     #
##########  #  ##########  #  #  #  ####  ####
#  #           #              #  #  #     #  #
#  #  ####  ###################  #  #  ####  #
#     #     #                 #     #  #     #
####  #  ###################  #  ####  #  #  #
#     #     #                    #     #  #  #
#  ##########  #############  ####  ####  #  #
#  #           #     #  #     #        #  #  #
####  ##########  #  #  #  #  #  #######  #  #
#     #           #  #     #  #  #     #  #  #
#  ################  ##########  ####  #  ####
#  #     #        #  #        #     #  #     #
#  ####  #  ####  #  #######  ####  #  ####  #
#     #     #     #        #     #  #        #
####  #######  ##########  ####  #  ####  #  #
#     #     #           #     #  #        #  #
#  #######  #######  ####  ####  ##########  #
#     #     #     #     #        #        #  #
####  #  ####  #  ####  #######  #  ####  #  #
#  #           #     #        #  #     #     #
#  #############  ####  ####  #  ####  ####  #
#  #     #              #     #           #  #
#  #  #  #  ####  #########################  #
#     #     #  #  #     #        #        #  #
####  #######  #  #  #  #  ####  #  ####  #  #
#     #     #        #     #           #     #
#  #######  ####  ####  ##########  #  ####  #
#        #  #     #     #           #  #     #
#######  #  #  ####  ##########  ####  #  ####
#     #     #     #  #           #     #     #
#  #  ##########  ####  ##########  ####  #  #
#  #              #     #           #     #  #
#  ################  ####  ##########  ####  #
#     #              #     #        #     #  #
####  #  #############  ####  ####  #  ####  #
#     #     #     #     #  #  #     #  #     #
#  #######  #  #  #######  #  #  #  ####  ####
#        #     #        #     #  #     #     #
####  #  #############  #  ##########  ####  #
#     #  #        #     #  #        #     #  #
#  ####  #  ####  #  #######  ##########  #  #
#  #     #     #  #  #        #        #     #
#  #  ##########  #  #  #######  ####  #######
#  #              #     #     #     #     #  #
#  ###################  #  #  ####  ####  #  #
#     #        #     #     #  #     #     #  #
####  #  ####  #  ##########  #  ####  #  #  #
#     #     #  #                    #  #  #  #
#  #  #######  #############  #######  #  #  #
#  #  #              #        #     #  #  #  #
#  ####  #############  ##########  #  #  #  #
#        #           #           #     #     #
##########  #######  ##########  #  ####  ####
#           #     #              #     #     #
#  ##########  #  #######  ##########  ####  #
#        #     #  #        #        #  #     #
#######  #  ####  #  #######  ####  #  #######
#  #     #     #           #  #     #        #
#  #  #######  ####  ####  #  #############  #
#     #  #        #     #  #     #           #
#  #  #  #  #  #######  #  ####  #############
#  #  #     #  #        #  #  #     #     #  #
#  #  #######  #  #######  #  ####  #  #  #  #
#  #        #  #     #  #     #     #  #     #
#  ##########  ####  #  #  ####  ####  #  ####
#  #     #     #     #  #  #     #     #     #
#  #  #  #  ####  ####  #  #  #  #  ####  #  #
#     #  #     #        #     #     #     #   
##############################################